USD - Американский доллар
CAD - Канадский доллар
EUR - Евро
GBP - Британский фунт
AFN - Афганский афгани
ALL - Албанский лек
DZD - Алжирский динар
AOA - Ангольская кванза
ARS - Аргентинское песо
AMD - Армянский драм
AWG - Арубанский флорин
AUD - Австралийский доллар
AZN - Азербайджанский манат
BSD - Багамский доллар
BHD - Бахрейнский динар
BDT - Бангладешская така
BBD - Барбадосский доллар
BYN - Белорусский рубль
BZD - Белизский доллар
BMD - Бермудский доллар
BTN - Бутанский нгултрум
BOB - Боливийский боливиано
BAM - Конвертируемая марка Боснии и Герцеговины
BWP - Ботсванская пула
BRL - Бразильский реал
BND - Брунейский доллар
BGN - Болгарский лев
MMK - Мьянманский кьят
BIF - Бурундийский франк
XPF - Французский тихоокеанский франк
KHR - Камбоджийский риель
CVE - Эскудо Кабо-Верде
KYD - Доллар Каймановых островов
XAF - Центральноафриканский франк КФА
CLP - Чилийское песо
CNY - Китайский юань
COP - Колумбийское песо
KMF - Коморский франк
CDF - Конголезский франк
CRC - Коста-риканский колон
HRK - Хорватская куна
CUC - Кубинское конвертируемое песо
CUP - Кубинское песо
CZK - Чешская крона
DKK - Датская крона
DJF - Джибутийский франк
DOP - Доминиканское песо
XCD - Восточно-карибский доллар
EGP - Египетский фунт
ERN - Эритрейская накфа
ETB - Эфиопский быр
FKP - Фунт Фолклендских островов
FJD - Фиджийский доллар
GMD - Гамбийский даласи
GEL - Грузинский лари
GHS - Ганский седи
GIP - Гибралтарский фунт
GTQ - Гватемальский кетсаль
GNF - Гвинейский франк
GYD - Гайанский доллар
HTG - Гаитянский гурд
HNL - Гондурасская лемпира
HKD - Гонконгский доллар
HUF - Венгерский форинт
ISK - Исландская крона
INR - Индийская рупия
IDR - Индонезийская рупия
IRR - Иранский риал
IQD - Иракский динар
ILS - Израильский шекель
JMD - Ямайский доллар
JPY - Японская иена
KZT - Казахстанский тенге
KES - Кенийский шиллинг
KWD - Кувейтский динар
KGS - Киргизский сом
LAK - Лаосский кип
LVL - Латвийский лат
LBP - Ливанский фунт
LSL - Лоти Лесото
LRD - Либерийский доллар
LYD - Ливийский динар
LTL - Литовский лит
MOP - Патака Макао
MKD - Македонский денар
MGA - Малагасийский ариари
MWK - Малавийская квача
MYR - Малайзийский ринггит
MVR - Мальдивская руфия
MRU - Мавританская угия
MUR - Маврикийская рупия
MXN - Мексиканское песо
MDL - Молдавский лей
MNT - Монгольский тугрик
MAD - Марокканский дирхам
MZN - Мозамбикский метикал
NAD - Намибийский доллар
NPR - Непальская рупия
ANG - Нидерландский антильский гульден
TWD - Новый тайваньский доллар
NZD - Новозеландский доллар
NIO - Никарагуанская кордоба
NGN - Нигерийская найра
KPW - Северокорейская вона
NOK - Норвежская крона
OMR - Оманский риал
PKR - Пакистанская рупия
PAB - Панамский бальбоа
PGK - Кина Папуа — Новой Гвинеи
PYG - Парагвайский гуарани
PEN - Перуанский соль
PHP - Филиппинское песо
PLN - Польский злотый
QAR - Катарский риал
RON - Румынский лей
RUB - Российский рубль
RWF - Руандийский франк
SHP - Фунт Святой Елены
SVC - Сальвадорский колон
WST - Самоанская тала
SAR - Саудовский риял
RSD - Сербский динар
SCR - Сейшельская рупия
SLL - Сьерра-леонский леоне
SGD - Сингапурский доллар
SBD - Доллар Соломоновых Островов
SOS - Сомалийский шиллинг
ZAR - Южноафриканский рэнд
KRW - Южнокорейская вона
SSP - Южносуданский фунт
LKR - Шри-ланкийская рупия
SDG - Суданский фунт
SRD - Суринамский доллар
SZL - Свазилендский лилангени
SEK - Шведская крона
CHF - Швейцарский франк
SYP - Сирийский фунт
STN - Добра Сан-Томе и Принсипи
TJS - Таджикский сомони
TZS - Танзанийский шиллинг
THB - Тайский бат
TOP - Тонганская паанга
TTD - Доллар Тринидада и Тобаго
TND - Тунисский динар
TRY - Турецкая лира
TMT - Туркменский манат
UGX - Угандийский шиллинг
UAH - Украинская гривна
AED - Дирхам ОАЭ
UYU - Уругвайское песо
UZS - Узбекский сум
VUV - Вануатский вату
VES - Венесуэльский боливар
VND - Вьетнамский донг
XOF - Западноафриканский франк КФА
YER - Йеменский риал
ZMW - Замбийская квача
ZWL - Доллар Зимбабве